..#####.
###...#.
#X..B@#.
###.BX#.
#.##B.#.
#.#.X.##
########